111111111
10P000001
1000EK001
1000CCC01
111111111