111111111111111111111111111111111
1EP00C000000000000000000000000001
1000001100000000000000000000C0001
100000100000000000000000000000001
100000000000000000000000000000001
100000000000000000000000000000001
100000C00000000000000000000000001
100000000000000000000000000000001
100000000000000000000000C00000001
100111111111111001111111111111001
1000000000000C0000000000000000001
100111111111110011111111111111001
100000000000000000000000000000001
10000000000000000C000000000000001
100000000000000000000000000000001
100000000000000000000000000000001
100000000000000000000000000000001
100000000000000000000000000000001
1000000C0000000000000000000000001
100000000000000000000000C00000001
10000000CCC0000000000000000000001
111111111111111111111111111111111