111111111
1000C0EC1
100C0C111
100PC0101
111111111