111111111111111111111111111111111
10000C000000000000000000000000001
1000001100000000000000000000E0001
10P000100000000000000000000000001
111111111111111111111111111111111