1111111111111111111111111111
1010000000000000000000000101
1110000110000000111111100111
10000011C0000000000001100001
10000100000000000000C1100001
100011C00000P000111111100001
1000111111000000110000000001
100000001100EC0011C000000001
1000000011001100111111100001
1110000000000000000000000111
1010000000000000000000000101
1111111111111111111111111111