111111111111111111
1P001000001C000001
101011100011111001
110000010010000011
100C01000C00P000E1
111111111111111111