111111111111111111
1P00100E001C000001
101011100011111001
110000010010000011
100C01000C000000E1
111111111111111111