111111111111111111
1E10000000000C1001
11100P000000000001
100000001000000001
100000010100000001
100000001000000001
100000000000000001
111111111111111111
