111111111111111111
1P0010000010000001
101011100011111001
110000010010000011
1000010000000000E1
111111111111111111