11111111111111111
10000000000000001
10000000000000001
10000000000000001
10000000000000001
10P0000CCC0000001
1000000CEC0000001
1000000CCC0000001
10000000000000001
10000000000000001
10000000000000001
10000000000000001
11111111111111111